SCC	= "countries/Sichuan Clique.txt"
CPC	= "countries/Chongqing Clique.txt"
NJC	= "countries/Nanjing Clique.txt"
HNA	= "countries/Hunan Clique.txt"
DGB	= "countries/Dongbei.txt"
FUJ = "countries/Fujian Clique.txt"
GZC = "countries/Guizhou Clique.txt"
FNG = "countries/Fengtian Gov.txt"
KML = "countries/Wuhan Gov.txt"
KMR = "countries/Kunming Gov.txt"
GMA = "countries/Ma Gansu.txt"
XSM = "countries/Ma Qinghai.txt"
SOV = "countries/Russia.txt"
HYD = "countries/Hyderabad.txt"
RJS = "countries/Rajasthan.txt"
SKH = "countries/Sikh.txt"
MRT = "countries/Maratha.txt"
GUJ = "countries/Gujarat.txt"
NAG = "countries/Nagpur.txt"
ORI = "countries/Orissa.txt"
MYS = "countries/Mysore.txt"
KER = "countries/Kerala.txt"
GWA = "countries/Gwalior.txt"
IND = "countries/IndiaNationalGovernment.txt"
BIH = "countries/Bihar.txt"
KSH = "countries/Kashmir.txt"
SND = "countries/Sind.txt"
KOR = "countries/Korea.txt"
QNG = "countries/Qing.txt"
SDC	= "countries/Shandong Clique.txt"
ZHL = "countries/Zhili Gov.txt"
KUM = "countries/kumul khanate.txt"
GDC = "countries/Guangdong Clique.txt"
YUN	= "countries/Yunnan Clique.txt"